|=========|     |=========|
|*........|     |........*|
|.|=====|.|=====|.|=====|.|
|.|.....................|.|
|...|==|.|=|.|.|=|.|==|...|
|.|.|  |.|=|.|.|=|.|  |.|.|
|.|.|  |.....|.....|  |.|.|
|.|.|==| |=======| |==|.|.|
|.|.... ??????????? ....|.|
|.|==|.|?|==^^^==|?|.|==|.|
|......|?| cibp  |?|......|
|.|.|==|?|=======|?|==|.|.|
|.|.... ??????????? ....|.|
|.|==|.|===| | |===|.|==|.|
|......|.....|.....|......|
|==| |.|.|=======|.|.| |==|
w    |.......P.......|    w
|====|.|===|.|.|===|.|====|
|......|.....|.....|......|
|.|==|.|.|=======|.|.|==|.|
|*|==|.|...........|.|==|*|
|........|=======|........|
|========|       |========|
