|=========================|
|*......|.........|......*|
|.|===|.|.|=====|.|.|===|.|
|.........................|
|===|.|.|=|.|=|.|=|.|.|===|
w    .|.|=|.| |.|=|.|.|____
|===|.|.....| |.....|.|____
    |.|===| |=| |===|.|____
    |. ????????????? .|____
    |.|=|?|=^^^=|?|=|.|____
    |.|???| ibcp|???|.|____
    |.|?|?|=====|?|?|.|===|
    |. ?|?????????|? .    w
    |.|====|.|.|====|.|===|
    |......|.|.|......|____
|===|.|==|.|.|.|.|==|.|===|
|............|............|
|.|===|.|==|.|.|==|.|===|.|
|.....|.|....P....|.|.....|
|.|=|.|...|=====|...|.|=|.|
|*|=|.|=|.|=====|.|=|.|=|*|
|.........................|
|=========================|
