|=========================|
|.........................|
|*|.|==|.|=======|.|==|.|*|
|.|......|.......|......|.|
|.|==|.|.|.|===|.|.|.|==|.|
|......|.....|.....|......|
|====|.|===|.|.|===|.|====|
w     .......|.......     w
|====|.| |=| | |=| |.|====|
|......|???????????|......|
|.|==|.|?|==^^^==|?|.|==|.|
|.|==|. ?| cibp  |? .|==|.|
|......|?|=======|?|......|
|==|.|.|???????????|.|.|==|
   |.|.| |=======| |.|.|___
   |.|...|.......|...|.|___
   |.|=|.|.|===|.|.|=|.|___
   |.........P.........|___
|==|.|=====|.|.|=====|.|==|
|....|.......|.......|....|
|.|==|.|===========|.|==|.|
|*.......................*|
|=========================|
