|=========|     |=========|
|*........|     |........*|
|.|=====|.|=====|.|=====|.|
|.|.....................|.|
|...|==|.|=|.|.|=|.|==|...|
|.|.|  |.|=|.|.|=|.|  |.|.|
|.|.|  |.....|.....|  |.|.|
|.|.|==| |=======| |==|.|.|
|.|.... ??????????? ....|.|
|.|==|.|?|=======|?|.|==|.|
|......|?| cibp  |?|......|
|.|.|==|?|==vvv==|?|==|.|.|
|.|.... ??????????? ....|.|
|.|==|.|=| |===| |=|.|==|.|
|......|=| |===| |=|......|
|==| |.......|.......| |==|
w    |.|.|=|.|.|=|.|.|    w
|====|.|.| |.|.| |.|.|====|
|......|.|=|.|.|=|.|......|
|.|==|.|.....P.....|.|==|.|
|*|==|.|.|=======|.|.|==|*|
|.........................|
|=========================|
