|===========| |===========|
w     ......| |......     w
|====|.|==|.|=|.|==|.|====|
|*.....|==|.....|==|.....*|
|.|==|......|=|......|==|.|
|.|==|.|==|.| |.|==|.|==|.|
|......|==|.|=|.|==|......|
|.|==|.......|.......|==|.|
|.|  |.|===| | |===|.|  |.|
|.|==|.|???????????|.|==|.|
|...... ?|==^^^==|? ......|
|.|==|.|?| ipbc  |?|.|==|.|
|.|==|.|?|=======|?|.|==|.|
|...... ??????????? ......|
|==|.|=| |=| | |=| |=|.|==|
   |.|=| |=| | |=| |=|.|___
   |.........P.........|___
   |.|=|.|=|.|.|=|.|=|.|___
|==|.|=|.|...|...|.|=|.|==|
|......|.|.|===|.|.|......|
|.|==|.|.|.|===|.|.|.|==|.|
|*.......................*|
|=========================|
