|=========================|
w     .......|.......     w
|====|.|.|=|.|.|=|.|.|====|
|*.....|.....|.....|.....*|
|.|====|.|=|.|.|=|.|====|.|
|.|........|...|........|.|
|.|.|====| |===| |====|.|.|
|...... ??????????? ......|
|====|.|?|=======|?|.|====|
|......|?|  bicp |?|......|
|.|==|.|?|==vvv==|?|.|==|.|
|....|. ??????????? .|....|
|==|.|.|==| |=| |==|.|.|==|
   |........| |........|___
   |.|====|.|=|.|====|.|___
   |...|.....P.....|...|___
   |.|.|.|=======|.|.|.|___
   |.|.|.....|.....|.|.|___
|==|...|.|=|.|.|=|.|...|==|
|....|...|=|.|.|=|...|....|
|.|====|...........|====|.|
|*.......|=======|.......*|
|========|       |========|
