|=========================|
|            |            |
| |==| |===| | |===| |==| |
| |==| |===| | |===| |==| |
|                         |
| |==| | |=======| | |==| |
| |==| | |=======| | |==| |
|      |     |     |      |
|====| |==== | ====| |====|
     | |???????????| |_____
|====| |?|==^^^==|?| |====|
w       ?| pbic  |?  _____w
|====| |?|=======|?| |====|
     | |???????????| |_____
|====| | |=======| | |====|
|            |            |
| |==| |===| | |===| |==| |
|    |* .....P       |    |
|==| | | |===|===| | | |==|
|      |     |     |      |
| |========| | |========| |
|                         |
|=========================|
